WE ./textures/naziwallpaper_north.xpm
NO ./textures/naziwallpaper_north.xpm
SO ./textures/naziwallpaper_north.xpm
EA ./textures/naziwallpaper_north.xpm


F 0,200,0
C 255,25,45

1111111
100000111
111111111
10011N11111
10010011
1111111
1111 11
1111 11
1111111